00000000000000001000000001000000
00000000000000001000000001000000
00000000000000001000000000000000
00000000000000001000000000000000
00000001000000001000000001000000
00000001000000001000000001000000
00000001000000001000000001000000
00000001000000000000000001000000
00000001000000000000000001000000
10011111111000000000000001000000
00010000001111111111111111111100
00010000000000000000000000000100
00010000000000000000000000000100
00010001000000000000000001000100
00010001000000000000000001000100
00010001000000000000000001000100
00010001000000000000000001000000
00010001000000000000000001000000
00000001000000000000000001000000
00000001000000000000000001000000
