000000000000100000000000100000
000000000000100000000000100000
000000000000000000000000000000
000100000000100000000000000000
000100000000100000000000100000
000100000000100000000000100000
000100000000100000000000100000
100111111111111111111111100110
000100000000000000001000000100
000100000000000000001000000100
000100000000000010001001000100
000100000000000010001001000100
000100000000000010001001000000
000100000000000010000001000000
000000000000000010000001000000
